#################
#......######...#
#.###...........#
#.#.#.@##########
#...#...........#
######.########.#
#......#........#
#################